Abad: cura
Abadejo: pescado en salazón
Abajar: bajar
Abajo: después
Abarranganado: amancebado
Abercuncio: abrenuncio, renuncio.
Abismo: mar
Abonar: avalar
Abono: en su favor, en su defensa
Abrir: cavar
Abrojo: rama seca
Absit: ¡lejos de nosotros!
Absolver: resolver, aclarar
Abundancia: las palabras suelen desvelar los sentimientos
Acabable: efímero
Acabado: perfecto
Acabar: llevar a cabo
Acaecer: suceder
Acaecimiento: suceso
Acamuzado: de color o aspecto de gamuza
Acardenalado: lleno de cardenales
Acardenalar: producir cardenales
Acariciar: tratar con cariño
Acaso: por casualidad
Acatamiento: respeto
Accidente: enfermedad que actúa junto a otra ya existente, agravando el estado de enfermo.
Acedo: seco, hosco
Aceite: producción de aceitunas
Acelerado: impulsivo, alocado
Acemila: mula que lleva las provisiones
Acento: canto
Acenia: molino en el cauce de un río
Acerado: de acero
Acertar: suceder
Achaque: caer en la cuenta
Acibar: jugo, muy amargo del áloe
Acicalado: brillante
Acion: correa
Babador: barbero
Badea: sandía
Bagaje: mula de carga
Bajel: embarcación de aparejo redondo
Balandro: alarido
Baratro: sima, abismo
Barbilucio: imberbe
Basilisco: animal fabuloso que mataba con la mirada
Bayeta: tela de lana
Beca: faja ancha ceñida al pecho
Billete: carta breve
Birlar: situar bien la bola
Bisunto: sucio
Bizarro: curioso
Bizma: encontrarse mal físicamente
Blandon: soporte para antorchas
Bocaci: tela de lino
Bonete: gorro
Borra: vello
Bracman: mago de la India
Braza: medida de longitud
Bronco: grosero
Brumar: machacar, moler, magullar
Burdo: tosco
Burleria: ilusión
Cabo: llevar hasta el fin y perfección
Cabrerizo: cabrero
Cadahalso: tarima para contemplar un acto público
Calar: bajar
Calongia: canonjía; prebenda
Camarada: compañero de alojamiento
Cambronero: arbusto espinoso
Camuza: piel suave
Carcanio: espolear
Cecina: carne cruda
Cerbelo: carebro
Cercen: cercenar, cortar
Ciani: moneda de oro de baja ley, usada entre los moros
Cimitarra: sable corto usado por turcos y persas
Cohonder: confundir
Coima: amante
Comitre: oficial que dirigía a los remeros
Concejil: del cencejo, común a todos
Coplear: hacer, decir o cantar coplas
Cuatrin: moneda de escaso valor
Cuesco: hueso de fruta
Cuita: sufrimiento
Culpa: delito
Cursado: acostumbrado
Cuyo: de quién
Daca: paja
Damasquiano: de Damasco
Dares: conflictos, reyertas
Demasia: osadía
Demostino: relativo a Demóstenes
Denantes: antes
Derrengado: deslomado, muy cansado
Diputado: estipulado, establecido
Discantar: comentar
Do: donde
Doblon: moneda de oro de gran valor
Dogmatizador: que dogmatiza
Domeniar: sometar
Driada: ninfa de los bosques
Dueniesco: propio de dueñas
Dulzaina: instrumento musical de viento
Echacuervos: charlatán y timador
Elche: cristiano renegado
Embaidor: embaucador
Embelesado: ensimismado
Embocarse: dirigirse
Endriagado: monstruo fabuloso
Ensarmentar: acodar, plantar el sarmiento doblado
Estoque: espada
Estrambote: canción amorosa
Estopa: residuo de hilo
Estropajo: antropófago
Exentar: eximir
Exequias: funeral
Fablar: hablar
Faca: yegua
Facilitar: resolver
Fada: hada
Faja: franja
Faldellin: falda interior
Falsia: mentiroso
Fanega: medida agraria de superficie
Fasta: hasta
Fechoria: hechicería
Felice: feliz
Fineza: delicadeza
Finojo: hinojo, rodilla
Facil: dócil
Follon: canalla
Frade: fraile
Franco: generoso
Frasis: manera de hablar
Frion: frío, soso
Fuero: costumbre
Fullero: tramposo en el juego
Fundar: renta
Furto: a hurto, a escondidas
Fustan: algodón
Galan: hombre atractivo
Galano: bien adornado
Ganapan: mozo de carga
Garamanta: persona de un pueblo antiguo de la Libia interior
Ganian: hombre rudo
Genizaro: soldado de infantería y especialmente de la guardia imperial turca
Gerifalte: ave de cetrería
Gigote: plato de carne picada y asada
Ginasio: colegio
Godo: noble
Gola: cuello
Gomia: monstruo fantástico de insaciable apetito
Gota: nada
Gozque: perro sin raza
Gracejar: gastar bromas
Gracia: hombre de pila
Grado: estado
Greba: parte de la armadura que protegía desde la rodilla hasta el tobillo
Grifo: animal fabuloso
Guardalla: guardar
Guedeja: mechón de cabello
Guilla: cosecha copiosa
Gurapas: condena de galeras
Gusto: voluntad